1 11 11 11 11 11 11 11 11 11 11 11 11 11 11 11 11 11 11 11 11 11 11 11 11 11 11 11 11 11 11 11 11 11 11 11 11 11 11 11 11 11 
1 11 12 12 12 11 12 12 12 12 12 12 12 12 12 11 12 11 12 12 12 12 12 12 12 12 12 12 12 12 11 11 12 12 12 12 12 11 12 12 12 11
1 11 12 11 12 11 12 11 12 11 11 11 11 11 12 11 12 11 12 11 11 11 12 11 11 11 11 11 12 11 12 11 12 11 12 11 11 11 12 11 12 11  
1 11 12 11 12 11 12 11 12 11 12 11 12 12 12 11 12 11 12 11 12 11 12 12 12 12 12 11 12 11 12 12 12 11 12 12 12 12 12 11 12 11
1 11 12 11 11 11 12 11 12 11 12 11 12 11 11 11 12 11 12 11 12 11 11 11 11 11 12 11 12 11 12 11 11 11 11 11 11 11 11 11 12 11
1 11 12 11 12 12 12 11 12 11 12 11 12 11 12 12 12 11 12 11 12 12 12 12 12 11 12 11 12 11 12 11 12 12 12 12 12 11 12 12 12 11 
1 11 12 11 11 11 12 11 12 11 12 11 12 11 12 11 11 11 12 11 12 11 11 11 11 11 12 11 12 11 12 11 12 11 11 11 12 11 12 11 11 11
1 11 12 12 12 11 12 11 12 11 12 12 12 11 12 12 12 12 12 11 12 11 12 12 12 12 12 11 12 11 12 12 12 12 12 11 12 11 12 12 12 11
1 11 11 11 12 11 11 11 12 11 12 11 11 11 11 11 11 11 12 11 12 11 12 11 11 11 11 11 12 11 11 11 11 11 11 11 12 11 11 11 12 11 
1 11 12 11 12 11 12 12 12 11 12 12 12 12 12 12 12 11 12 12 12 11 12 11 12 12 12 11 12 12 12 12 12 11 12 12 12 12 12 11 12 11 
1 11 12 11 12 11 12 11 11 11 11 11 11 11 11 11 12 11 11 11 11 11 12 11 12 11 12 11 11 11 11 11 12 11 11 11 11 11 12 11 12 11
1 11 12 12 12 11 12 12 12 12 12 11 12 12 12 11 12 12 12 12 12 12 12 11 12 11 12 11 12 12 12 11 12 11 12 12 12 11 12 11 12 11
1 11 12 11 11 11 11 11 11 11 12 11 12 11 11 11 11 11 11 11 11 11 11 11 11 11 12 11 11 11 12 11 12 11 12 11 12 11 11 11 12 11
1 11 12 12 12 12 12 11 12 12 12 11 12 12 12 12 12 12 12 12 12 12 12 11 12 12 12 11 12 11 12 11 12 11 12 11 12 12 12 11 12 11
1 11 11 11 11 11 12 11 12 11 11 11 11 11 11 11 11 11 12 11 11 11 12 11 12 11 12 11 12 11 12 11 12 11 12 11 11 11 12 11 12 11
1 11 12 11 12 12 12 11 12 11 12 12 12 12 12 12 12 11 12 11 12 12 12 11 12 11 12 12 12 11 12 11 12 12 12 11 12 11 12 11 12 11
1 11 12 11 12 11 11 11 12 11 12 11 11 11 11 11 12 11 11 11 12 11 11 11 12 11 11 11 11 11 12 11 11 11 11 11 12 11 12 11 12 11
1 11 12 12 12 11 12 12 12 11 12 11 12 12 12 11 12 12 12 11 12 12 12 11 12 12 12 11 12 11 12 12 12 12 12 12 12 11 12 11 12 11
1 11 12 11 11 11 12 11 11 11 12 11 12 11 11 11 11 11 12 11 12 11 12 11 11 11 12 11 12 11 12 11 11 11 11 11 12 11 12 11 12 11 
1 11 12 12 12 11 12 11 12 12 12 12 12 11 12 12 12 12 12 11 12 11 12 12 12 11 12 11 12 11 12 11 12 12 12 11 12 11 12 11 12 12 
1 11 11 11 12 11 12 11 12 11 11 11 11 11 12 11 11 11 11 11 12 11 11 11 12 11 12 11 12 11 12 11 12 11 12 11 11 11 12 11 12 11
1 11 12 11 12 11 12 12 12 11 12 12 12 11 12 12 12 12 12 11 12 11 12 11 12 11 12 12 12 11 12 12 12 11 12 12 12 11 12 12 12 11 
1 11 12 11 12 11 11 11 11 11 12 11 12 11 11 11 11 11 12 11 12 11 12 11 12 11 11 11 12 11 11 11 11 11 11 11 12 11 11 11 12 11 
1 12 12 12 12 12 12 12 12 12 12 11 12 12 12 12 12 12 12 11 12 12 12 11 12 12 12 12 12 12 12 12 12 12 12 11 12 12 12 12 12 11 
1 11 11 11 11 11 11 11 11 11 11 11 11 11 11 11 11 11 11 11 11 11 11 11 11 11 11 11 11 11 11 11 11 11 11 11 11 11 11 11 11 11 











