1 11 11 11 11 11 11 11 11 11 11 11 11 11 11 11 11 11 11 11 11 11 11 11 11 11 11 13 11 11 11 11 11 11 11 11 11 11 11 11 11 11 
1 11 13 13 13 11 13 13 13 13 13 13 13 13 13 11 13 11 13 13 13 13 13 13 13 13 13 13 13 13 11 11 13 13 13 13 13 11 13 13 13 11
1 11 13 11 13 11 13 11 13 11 11 11 11 11 13 11 13 11 13 11 11 11 13 11 11 11 11 11 13 11 13 11 13 11 13 11 11 11 13 11 13 11  
1 11 13 11 13 11 13 11 13 11 13 11 13 13 13 11 13 11 13 11 13 11 13 13 13 13 13 11 13 11 13 13 13 11 13 13 13 13 13 11 13 11
1 11 13 11 11 11 13 11 13 11 13 11 13 11 11 11 13 11 13 11 13 11 11 11 11 11 13 11 13 11 13 11 11 11 11 11 11 11 11 11 13 11
1 11 13 11 13 13 13 11 13 11 13 11 13 11 13 13 13 11 13 11 13 13 13 13 13 11 13 11 13 11 13 11 13 13 13 13 13 11 13 13 13 11 
1 11 13 11 11 11 13 11 13 11 13 11 13 11 13 11 11 11 13 11 13 11 11 11 11 11 13 11 13 11 13 11 13 11 11 11 13 11 13 11 11 11
1 11 13 13 13 11 13 11 13 11 13 13 13 11 13 13 13 13 13 11 13 11 13 13 13 13 13 11 13 11 13 13 13 13 13 11 13 11 13 13 13 11
1 11 11 11 13 11 11 11 13 11 13 11 11 11 11 11 11 11 13 11 13 11 13 11 11 11 11 11 13 11 11 11 11 11 11 11 13 11 11 11 13 11 
1 11 13 11 13 11 13 13 13 11 13 13 13 13 13 13 13 11 13 13 13 11 13 11 13 13 13 11 13 13 13 13 13 11 13 13 13 13 13 11 13 11 
1 11 13 11 13 11 13 11 11 11 11 11 11 11 11 11 13 11 11 11 11 11 13 11 13 11 13 11 11 11 11 11 13 11 11 11 11 11 13 11 13 11
1 11 13 13 13 11 13 13 13 13 13 11 13 13 13 11 13 13 13 13 13 13 13 11 13 11 13 11 13 13 13 11 13 11 13 13 13 11 13 11 13 11
1 11 13 11 11 11 11 11 11 11 13 11 13 11 11 11 11 11 11 11 11 11 11 11 11 11 13 11 11 11 13 11 13 11 13 11 13 11 11 11 13 11
1 11 13 13 13 13 13 11 13 13 13 11 13 13 13 13 13 13 13 13 13 13 13 11 13 13 13 11 13 11 13 11 13 11 13 11 13 13 13 11 13 11
1 11 11 11 11 11 13 11 13 11 11 11 11 11 11 11 11 11 13 11 11 11 13 11 13 11 13 11 13 11 13 11 13 11 13 11 11 11 13 11 13 11
1 11 13 11 13 13 13 11 13 11 13 13 13 13 13 13 13 11 13 11 13 13 13 11 13 11 13 13 13 11 13 11 13 13 13 11 13 11 13 11 13 11
1 11 13 11 13 11 11 11 13 11 13 11 11 11 11 11 13 11 11 11 13 11 11 11 13 11 11 11 11 11 13 11 11 11 11 11 13 11 13 11 13 11
1 11 13 13 13 11 13 13 13 11 13 11 13 13 13 11 13 13 13 11 13 13 13 11 13 13 13 11 13 11 13 13 13 13 13 13 13 11 13 11 13 11
1 11 13 11 11 11 13 11 11 11 13 11 13 11 11 11 11 11 13 11 13 11 13 11 11 11 13 11 13 11 13 11 11 11 11 11 13 11 13 11 13 11 
1 11 13 13 13 11 13 11 13 13 13 13 13 11 13 13 13 13 13 11 13 11 13 13 13 11 13 11 13 11 13 11 13 13 13 11 13 11 13 11 13 13 
1 11 11 11 13 11 13 11 13 11 11 11 11 11 13 11 11 11 11 11 13 11 11 11 13 11 13 11 13 11 13 11 13 11 13 11 11 11 13 11 13 11
1 11 13 11 13 11 13 13 13 11 13 13 13 11 13 13 13 13 13 11 13 11 13 11 13 11 13 13 13 11 13 13 13 11 13 13 13 11 13 13 13 11 
1 11 13 11 13 11 11 11 11 11 13 11 13 11 11 11 11 11 13 11 13 11 13 11 13 11 11 11 13 11 11 11 11 11 11 11 13 11 11 11 13 11 
1 11 13 13 13 13 13 13 13 13 13 11 13 13 13 13 13 13 13 11 13 13 13 11 13 13 13 13 13 13 13 13 13 13 13 11 13 13 13 13 13 11 
1 11 11 11 11 11 11 11 11 11 11 11 11 11 11 11 11 11 11 11 11 11 11 11 11 11 11 11 11 11 11 11 11 11 11 11 11 11 11 11 11 11 
