1 10 10 10 10 10 10 10 10 10 10 10 10 10 10 10 10 10 10 10 10 10 10 10 10 10 10 10 10 10 10 10 10 10 10 10 10 10 10 10 10 10 
1 10 4 6 9 10 8 8 7 4 7 5 9 7 8 10 5 10 8 3 8 8 7 9 8 5 6 8 3 9 10 10 4 7 7 4 3 10 3 6 3 10 
1 10 5 10 7 10 5 10 5 10 10 10 10 10 3 10 9 10 4 10 10 10 6 10 10 10 10 10 6 10 5 10 7 10 5 10 10 10 5 10 8 10 
1 3 6 10 7 10 3 10 5 10 7 10 6 8 3 10 8 10 4 10 3 10 6 8 6 4 8 10 7 10 8 5 9 10 3 7 9 5 8 10 9 10 
1 10 9 10 10 10 8 10 7 10 6 10 8 10 10 10 7 10 5 10 7 10 10 10 10 10 7 10 9 10 3 10 10 10 10 10 10 10 10 10 4 10 
1 10 4 10 3 8 4 10 7 10 4 10 4 10 7 9 6 10 5 10 6 8 5 9 3 10 3 10 3 10 9 10 3 4 8 4 7 10 6 4 4 10 
1 10 8 10 10 10 5 10 9 10 4 10 3 10 6 10 10 10 7 10 6 10 10 10 10 10 3 10 9 10 5 10 9 10 10 10 9 10 8 10 10 10 
1 10 4 4 3 10 5 10 4 10 7 8 5 10 6 3 9 4 4 10 8 10 4 8 3 9 3 10 4 10 9 5 6 6 9 10 5 10 3 4 6 10 
1 10 10 10 5 10 10 10 7 10 4 10 10 10 10 10 10 10 7 10 5 10 5 10 10 10 10 10 5 10 10 10 10 10 10 10 3 10 10 10 6 10 
1 10 4 10 3 10 5 9 5 10 4 6 8 8 8 5 4 10 8 3 8 10 7 10 8 4 7 10 8 6 5 4 8 10 9 3 9 6 6 10 6 10 
1 10 9 10 5 10 4 10 10 10 10 10 10 10 10 10 4 10 10 10 10 10 5 10 6 10 8 10 10 10 10 10 5 10 10 10 10 10 6 10 4 10 
1 10 5 8 7 10 9 5 7 5 5 10 6 8 9 10 6 4 5 6 5 9 9 10 8 10 8 10 3 7 9 10 3 10 3 3 6 10 8 10 7 10 
1 10 6 10 10 10 10 10 10 10 8 10 5 10 10 10 10 10 10 10 10 10 10 10 10 10 7 10 10 10 7 10 9 10 3 10 5 10 10 10 9 10 
1 10 8 7 5 4 4 10 6 7 9 10 7 5 4 3 3 7 3 5 5 3 7 10 7 4 9 10 6 10 8 10 5 10 8 10 3 7 4 10 3 10 
1 10 10 10 10 10 7 10 8 10 10 10 10 10 10 10 10 10 8 10 10 10 4 10 5 10 6 10 5 10 4 10 8 10 6 10 10 10 5 10 6 10 
1 10 3 10 6 5 5 10 9 10 9 6 8 7 5 8 4 10 4 10 6 9 5 10 8 10 6 3 3 10 8 10 9 9 7 10 8 10 7 10 3 10 
1 10 3 10 6 10 10 10 9 10 6 10 10 10 10 10 9 10 10 10 6 10 10 10 7 10 10 10 10 10 7 10 10 10 10 10 9 10 3 10 4 10 
1 10 3 8 9 10 6 7 4 10 7 10 9 7 8 10 6 4 8 10 8 9 9 10 4 9 5 10 9 10 3 9 4 8 9 7 8 10 6 10 9 10 
1 10 6 10 10 10 4 10 10 10 4 10 9 10 10 10 10 10 3 10 8 10 7 10 10 10 9 10 6 10 8 10 10 10 10 10 3 10 4 10 3 10 
1 10 3 8 9 10 8 10 5 5 4 4 8 10 5 7 8 3 7 10 3 10 4 5 8 10 4 10 4 10 9 10 6 8 9 10 8 10 9 10 4 7 
1 10 10 10 5 10 7 10 9 10 10 10 10 10 8 10 10 10 10 10 4 10 10 10 6 10 7 10 4 10 3 10 8 10 5 10 10 10 7 10 5 10 
1 10 5 10 9 10 4 4 5 10 7 6 5 10 5 7 3 4 3 10 6 10 3 10 9 10 4 3 8 10 4 9 5 10 7 4 4 10 3 5 7 10 
1 10 8 10 8 10 10 10 10 10 6 10 8 10 10 10 10 10 6 10 5 10 6 10 7 10 10 10 5 10 10 10 10 10 10 10 9 10 10 10 8 10 
1 10 7 5 8 9 9 8 9 3 6 10 7 4 9 6 4 7 4 10 8 5 4 10 8 6 6 6 5 6 7 3 9 5 4 10 4 5 3 8 9 10 
1 10 10 10 10 10 10 10 10 10 10 10 10 10 10 10 10 10 10 10 10 10 10 10 10 10 10 10 10 10 10 10 10 10 10 10 10 10 10 10 10 10